#...............................................................
# //==============[5]====================[3]==================[1]
# ||                                      ||                  ||
# ||                                      ||                  ||
# [6]===============[0]==================[4]                  ||
# ||                                    //||                  ||
# ||       //==========================// ||                  ||
# ||      //       //====================[2]==================//
#  \\====[7]======//
#...............................................................
#valid_map_with_comments
#comment
10
##start
1 23 3
2 16 7
3 16 3
#
4 16 5
5 9 3
6 1 5
7 4 8
##end
0 9 5
0-4
0-6
1-3
4-3
#comment
5-2
3-5
4-2
2-1
7-6
7-2
7-4
6-5
#comment